STAR --quantMode GeneCounts --genomeDir ../genome --runThreadN 2 --readFilesIn HUVECs_1_paired.fastq.gz,HUVECs_2_paired.fastq.gz	--readFilesCommand zcat --outFileNamePrefix wt1_ --outFilterMultimapNmax 1 --outFilterMismatchNmax 2 --outSAMtype BAM SortedByCoordinate
STAR --quantMode GeneCounts --genomeDir ../genome --runThreadN 2 --readFilesIn VM015_1_paired.fastq.gz,VM015_2_paired.fastq.gz	--readFilesCommand zcat --outFileNamePrefix wt2_ --outFilterMultimapNmax 1 --outFilterMismatchNmax 2 --outSAMtype BAM SortedByCoordinate
STAR --quantMode GeneCounts --genomeDir ../genome --runThreadN 2 --readFilesIn VM024_1_paired.fastq.gz,VM024_2_paired.fastq.gz	--readFilesCommand zcat --outFileNamePrefix wt3_ --outFilterMultimapNmax 1 --outFilterMismatchNmax 2 --outSAMtype BAM SortedByCoordinate
STAR --quantMode GeneCounts --genomeDir ../genome --runThreadN 2 --readFilesIn VM038_1_paired.fastq.gz,VM038_2_paired.fastq.gz	--readFilesCommand zcat --outFileNamePrefix wt4_ --outFilterMultimapNmax 1 --outFilterMismatchNmax 2 --outSAMtype BAM SortedByCoordinate
STAR --quantMode GeneCounts --genomeDir ../genome --runThreadN 2 --readFilesIn VM040_1_paired.fastq.gz,VM040_2_paired.fastq.gz	--readFilesCommand zcat --outFileNamePrefix wt5_ --outFilterMultimapNmax 1 --outFilterMismatchNmax 2 --outSAMtype BAM SortedByCoordinate
STAR --quantMode GeneCounts --genomeDir ../genome --runThreadN 2 --readFilesIn VM042_1_paired.fastq.gz,VM042_2_paired.fastq.gz	--readFilesCommand zcat --outFileNamePrefix wt6_ --outFilterMultimapNmax 1 --outFilterMismatchNmax 2 --outSAMtype BAM SortedByCoordinate
STAR --quantMode GeneCounts --genomeDir ../genome --runThreadN 2 --readFilesIn VM043_1_paired.fastq.gz,VM043_2_paired.fastq.gz	--readFilesCommand zcat --outFileNamePrefix wt7_ --outFilterMultimapNmax 1 --outFilterMismatchNmax 2 --outSAMtype BAM SortedByCoordinate
STAR --quantMode GeneCounts --genomeDir ../genome --runThreadN 2 --readFilesIn VM048_1_paired.fastq.gz,VM048_2_paired.fastq.gz	--readFilesCommand zcat --outFileNamePrefix wt8_ --outFilterMultimapNmax 1 --outFilterMismatchNmax 2 --outSAMtype BAM SortedByCoordinate
STAR --quantMode GeneCounts --genomeDir ../genome --runThreadN 2 --readFilesIn VM053_1_paired.fastq.gz,VM053_2_paired.fastq.gz	--readFilesCommand zcat --outFileNamePrefix wt9_ --outFilterMultimapNmax 1 --outFilterMismatchNmax 2 --outSAMtype BAM SortedByCoordinate
STAR --quantMode GeneCounts --genomeDir ../genome --runThreadN 2 --readFilesIn VM054_1_paired.fastq.gz,VM054_2_paired.fastq.gz	--readFilesCommand zcat --outFileNamePrefix wt10_ --outFilterMultimapNmax 1 --outFilterMismatchNmax 2 --outSAMtype BAM SortedByCoordinate
STAR --quantMode GeneCounts --genomeDir ../genome --runThreadN 2 --readFilesIn VM055_1_paired.fastq.gz,VM055_2_paired.fastq.gz	--readFilesCommand zcat --outFileNamePrefix wt11_ --outFilterMultimapNmax 1 --outFilterMismatchNmax 2 --outSAMtype BAM SortedByCoordinate
STAR --quantMode GeneCounts --genomeDir ../genome --runThreadN 2 --readFilesIn VM056_1_paired.fastq.gz,VM056_2_paired.fastq.gz	--readFilesCommand zcat --outFileNamePrefix wt12_ --outFilterMultimapNmax 1 --outFilterMismatchNmax 2 --outSAMtype BAM SortedByCoordinate
STAR --quantMode GeneCounts --genomeDir ../genome --runThreadN 2 --readFilesIn VM060_1_paired.fastq.gz,VM060_2_paired.fastq.gz	--readFilesCommand zcat --outFileNamePrefix wt13_ --outFilterMultimapNmax 1 --outFilterMismatchNmax 2 --outSAMtype BAM SortedByCoordinate
STAR --quantMode GeneCounts --genomeDir ../genome --runThreadN 2 --readFilesIn VM064_1_paired.fastq.gz,VM064_2_paired.fastq.gz	--readFilesCommand zcat --outFileNamePrefix wt14_ --outFilterMultimapNmax 1 --outFilterMismatchNmax 2 --outSAMtype BAM SortedByCoordinate
STAR --quantMode GeneCounts --genomeDir ../genome --runThreadN 2 --readFilesIn VM066_1_paired.fastq.gz,VM066_2_paired.fastq.gz	--readFilesCommand zcat --outFileNamePrefix wt15_ --outFilterMultimapNmax 1 --outFilterMismatchNmax 2 --outSAMtype BAM SortedByCoordinate
STAR --quantMode GeneCounts --genomeDir ../genome --runThreadN 2 --readFilesIn VM068_1_paired.fastq.gz,VM068_2_paired.fastq.gz	--readFilesCommand zcat --outFileNamePrefix wt16_ --outFilterMultimapNmax 1 --outFilterMismatchNmax 2 --outSAMtype BAM SortedByCoordinate
STAR --quantMode GeneCounts --genomeDir ../genome --runThreadN 2 --readFilesIn VM071_1_paired.fastq.gz,VM071_2_paired.fastq.gz	--readFilesCommand zcat --outFileNamePrefix wt17_ --outFilterMultimapNmax 1 --outFilterMismatchNmax 2 --outSAMtype BAM SortedByCoordinate
STAR --quantMode GeneCounts --genomeDir ../genome --runThreadN 2 --readFilesIn VM072_1_paired.fastq.gz,VM072_2_paired.fastq.gz	--readFilesCommand zcat --outFileNamePrefix wt18_ --outFilterMultimapNmax 1 --outFilterMismatchNmax 2 --outSAMtype BAM SortedByCoordinate
STAR --quantMode GeneCounts --genomeDir ../genome --runThreadN 2 --readFilesIn VM073_1_paired.fastq.gz,VM073_2_paired.fastq.gz	--readFilesCommand zcat --outFileNamePrefix wt19_ --outFilterMultimapNmax 1 --outFilterMismatchNmax 2 --outSAMtype BAM SortedByCoordinate
STAR --quantMode GeneCounts --genomeDir ../genome --runThreadN 2 --readFilesIn VM081_1_paired.fastq.gz,VM081_2_paired.fastq.gz	--readFilesCommand zcat --outFileNamePrefix wt20_ --outFilterMultimapNmax 1 --outFilterMismatchNmax 2 --outSAMtype BAM SortedByCoordinate
STAR --quantMode GeneCounts --genomeDir ../genome --runThreadN 2 --readFilesIn VM082_1_paired.fastq.gz,VM082_2_paired.fastq.gz	--readFilesCommand zcat --outFileNamePrefix wt21_ --outFilterMultimapNmax 1 --outFilterMismatchNmax 2 --outSAMtype BAM SortedByCoordinate
STAR --quantMode GeneCounts --genomeDir ../genome --runThreadN 2 --readFilesIn VM083_1_paired.fastq.gz,VM083_2_paired.fastq.gz	--readFilesCommand zcat --outFileNamePrefix wt22_ --outFilterMultimapNmax 1 --outFilterMismatchNmax 2 --outSAMtype BAM SortedByCoordinate
STAR --quantMode GeneCounts --genomeDir ../genome --runThreadN 2 --readFilesIn VM085_1_paired.fastq.gz,VM085_2_paired.fastq.gz	--readFilesCommand zcat --outFileNamePrefix wt23_ --outFilterMultimapNmax 1 --outFilterMismatchNmax 2 --outSAMtype BAM SortedByCoordinate
STAR --quantMode GeneCounts --genomeDir ../genome --runThreadN 2 --readFilesIn VM089_1_paired.fastq.gz,VM089_2_paired.fastq.gz	--readFilesCommand zcat --outFileNamePrefix wt24_ --outFilterMultimapNmax 1 --outFilterMismatchNmax 2 --outSAMtype BAM SortedByCoordinate
STAR --quantMode GeneCounts --genomeDir ../genome --runThreadN 2 --readFilesIn VM090_1_paired.fastq.gz,VM090_2_paired.fastq.gz	--readFilesCommand zcat --outFileNamePrefix wt25_ --outFilterMultimapNmax 1 --outFilterMismatchNmax 2 --outSAMtype BAM SortedByCoordinate
STAR --quantMode GeneCounts --genomeDir ../genome --runThreadN 2 --readFilesIn VM092_1_paired.fastq.gz,VM092_2_paired.fastq.gz	--readFilesCommand zcat --outFileNamePrefix wt26_ --outFilterMultimapNmax 1 --outFilterMismatchNmax 2 --outSAMtype BAM SortedByCoordinate
STAR --quantMode GeneCounts --genomeDir ../genome --runThreadN 2 --readFilesIn VM093_1_paired.fastq.gz,VM093_2_paired.fastq.gz	--readFilesCommand zcat --outFileNamePrefix wt27_ --outFilterMultimapNmax 1 --outFilterMismatchNmax 2 --outSAMtype BAM SortedByCoordinate
STAR --quantMode GeneCounts --genomeDir ../genome --runThreadN 2 --readFilesIn VM099_1_paired.fastq.gz,VM099_2_paired.fastq.gz	--readFilesCommand zcat --outFileNamePrefix wt28_ --outFilterMultimapNmax 1 --outFilterMismatchNmax 2 --outSAMtype BAM SortedByCoordinate
STAR --quantMode GeneCounts --genomeDir ../genome --runThreadN 2 --readFilesIn VM103_1_paired.fastq.gz,VM103_2_paired.fastq.gz	--readFilesCommand zcat --outFileNamePrefix wt29_ --outFilterMultimapNmax 1 --outFilterMismatchNmax 2 --outSAMtype BAM SortedByCoordinate
STAR --quantMode GeneCounts --genomeDir ../genome --runThreadN 2 --readFilesIn VM108_1_paired.fastq.gz,VM108_2_paired.fastq.gz	--readFilesCommand zcat --outFileNamePrefix wt30_ --outFilterMultimapNmax 1 --outFilterMismatchNmax 2 --outSAMtype BAM SortedByCoordinate
STAR --quantMode GeneCounts --genomeDir ../genome --runThreadN 2 --readFilesIn VM110_1_paired.fastq.gz,VM110_2_paired.fastq.gz	--readFilesCommand zcat --outFileNamePrefix wt31_ --outFilterMultimapNmax 1 --outFilterMismatchNmax 2 --outSAMtype BAM SortedByCoordinate
STAR --quantMode GeneCounts --genomeDir ../genome --runThreadN 2 --readFilesIn VM111_1_paired.fastq.gz,VM111_2_paired.fastq.gz	--readFilesCommand zcat --outFileNamePrefix wt32_ --outFilterMultimapNmax 1 --outFilterMismatchNmax 2 --outSAMtype BAM SortedByCoordinate
STAR --quantMode GeneCounts --genomeDir ../genome --runThreadN 2 --readFilesIn VM113_1_paired.fastq.gz,VM113_2_paired.fastq.gz	--readFilesCommand zcat --outFileNamePrefix wt33_ --outFilterMultimapNmax 1 --outFilterMismatchNmax 2 --outSAMtype BAM SortedByCoordinate
STAR --quantMode GeneCounts --genomeDir ../genome --runThreadN 2 --readFilesIn VM119_1_paired.fastq.gz,VM119_2_paired.fastq.gz	--readFilesCommand zcat --outFileNamePrefix wt34_ --outFilterMultimapNmax 1 --outFilterMismatchNmax 2 --outSAMtype BAM SortedByCoordinate
STAR --quantMode GeneCounts --genomeDir ../genome --runThreadN 2 --readFilesIn VM124_1_paired.fastq.gz,VM124_2_paired.fastq.gz	--readFilesCommand zcat --outFileNamePrefix wt35_ --outFilterMultimapNmax 1 --outFilterMismatchNmax 2 --outSAMtype BAM SortedByCoordinate
STAR --quantMode GeneCounts --genomeDir ../genome --runThreadN 2 --readFilesIn VM125_1_paired.fastq.gz,VM125_2_paired.fastq.gz	--readFilesCommand zcat --outFileNamePrefix wt36_ --outFilterMultimapNmax 1 --outFilterMismatchNmax 2 --outSAMtype BAM SortedByCoordinate
STAR --quantMode GeneCounts --genomeDir ../genome --runThreadN 2 --readFilesIn VM127_1_paired.fastq.gz,VM127_2_paired.fastq.gz	--readFilesCommand zcat --outFileNamePrefix wt37_ --outFilterMultimapNmax 1 --outFilterMismatchNmax 2 --outSAMtype BAM SortedByCoordinate
